03 01 09 08 00 11 00 01 11 06 00 08 03 03 08 05 
09 03 03 07 01 05 10 02 06 05 00 00 06 04 09 01 
01 05 09 00 04 03 07 07 01 04 01 10 01 10 03 07 
03 08 04 04 07 03 07 05 09 05 02 00 07 10 03 10 
04 09 00 00 11 01 04 09 07 01 10 10 00 05 02 11 
10 02 06 04 04 07 07 04 08 09 00 05 05 08 01 04 
01 11 04 02 04 06 08 08 00 05 07 10 11 08 02 02 
02 01 06 03 11 05 01 00 09 03 01 07 10 06 04 02 
10 05 01 08 03 04 11 03 00 00 11 04 05 02 06 07 
03 09 11 06 08 05 10 08 10 08 02 11 08 11 04 09 
01 00 00 01 11 03 00 02 07 02 11 00 04 05 03 07 
01 09 06 00 03 03 01 00 05 00 11 08 10 01 08 07 
